111111111111111111111111111111111111111
1010P0000000000C10000000000000000000001
111010000000001100100000000000000000001
100000000001000000100000000000000000001
1000000000000000E0100000000000000000001
100000011100000000100000000000000000001
100000100000000000100000000000000000001
111111111111111111111111111111111111111